{
	"level_info": {
		"level_id": 1,
		"level_name": "Grassland 1-1",
		"time_limit_seconds": 180,
		"bgm_track": "theme_01.ogg"
	},

	"grid_config": {
		"cell_width": 32,
		"cell_height": 32,
		"columns": 15,
		"rows": 13
	},

	"spawn_points": {
		"player_1": {"x": 1, "y": 1},
		"player_2": {"x": 13, "y": 11},
		"enemies": [
			{"type": "slime", "x": 13, "y": 1},
			{"type": "slime", "x": 1, "y": 11},
			{"type": "ghost", "x": 7, "y": 5}
		]
	},

	"item_drop_rates": {
		"bomb_up": 0.4,
		"fire_range_up": 0.4,
		"speed_up": 0.1,
		"empty": 0.1
	},

	"map_layout": [
		[1, 1, 1, 1, 1, 1, 1, 1, 1, 1, 1, 1, 1, 1, 1],
		[1, 0, 0, 2, 2, 0, 2, 2, 2, 0, 2, 0, 0, 0, 1],
		[1, 0, 1, 2, 1, 2, 1, 2, 1, 2, 1, 2, 1, 0, 1],
		[1, 2, 2, 2, 2, 2, 2, 2, 2, 2, 2, 2, 2, 2, 1],
		[1, 2, 1, 2, 1, 2, 1, 2, 1, 2, 1, 2, 1, 2, 1],
		[1, 2, 2, 2, 2, 2, 2, 2, 2, 2, 2, 2, 2, 2, 1],
		[1, 2, 1, 2, 1, 2, 1, 2, 1, 2, 1, 2, 1, 2, 1],
		[1, 2, 2, 2, 2, 2, 2, 2, 2, 2, 2, 2, 2, 2, 1],
		[1, 2, 1, 2, 1, 2, 1, 2, 1, 2, 1, 2, 1, 2, 1],
		[1, 2, 2, 2, 2, 2, 2, 2, 2, 2, 2, 2, 2, 2, 1],
		[1, 0, 1, 2, 1, 2, 1, 2, 1, 2, 1, 2, 1, 0, 1],
		[1, 0, 0, 2, 2, 0, 2, 2, 2, 0, 2, 0, 0, 0, 1],
		[1, 1, 1, 1, 1, 1, 1, 1, 1, 1, 1, 1, 1, 1, 1]
	]
}
