{
	"level_info": {
		"level_id": 3,
		"level_name": "Grassland 1-3",
		"time_limit_seconds": 240,
		"bgm_track": "theme_01.ogg"
	},
	"grid_config": {
		"cell_width": 32,
		"cell_height": 32,
		"columns": 15,
		"rows": 13
	},
	"spawns": [
		{"type": "player_start", "x": 1, "y": 1},
		{"type": "player_start", "x": 13, "y": 11},
		{"type": "player_start", "x": 1, "y": 11},
		{"type": "player_start", "x": 13, "y": 1}
	],
	"item_drop_rates": {
		"bomb_up": 0.3,
		"fire_range_up": 0.4,
		"speed_up": 0.2,
		"empty": 0.1
	},
	"map_layout": [
		[1, 1, 1, 1, 1, 1, 1, 1, 1, 1, 1, 1, 1, 1, 1],
		[1, 0, 0, 2, 2, 2, 1, 2, 1, 2, 2, 2, 0, 0, 1],
		[1, 0, 1, 2, 1, 0, 0, 0, 0, 0, 1, 2, 1, 0, 1],
		[1, 2, 2, 2, 1, 0, 1, 1, 1, 0, 1, 2, 2, 2, 1],
		[1, 2, 1, 1, 1, 0, 1, 2, 1, 0, 1, 1, 1, 2, 1],
		[1, 2, 0, 0, 0, 0, 2, 2, 2, 0, 0, 0, 0, 2, 1],
		[1, 1, 1, 1, 1, 2, 2, 2, 2, 2, 1, 1, 1, 1, 1],
		[1, 2, 0, 0, 0, 0, 2, 2, 2, 0, 0, 0, 0, 2, 1],
		[1, 2, 1, 1, 1, 0, 1, 2, 1, 0, 1, 1, 1, 2, 1],
		[1, 2, 2, 2, 1, 0, 1, 1, 1, 0, 1, 2, 2, 2, 1],
		[1, 0, 1, 2, 1, 0, 0, 0, 0, 0, 1, 2, 1, 0, 1],
		[1, 0, 0, 2, 2, 2, 1, 2, 1, 2, 2, 2, 0, 0, 1],
		[1, 1, 1, 1, 1, 1, 1, 1, 1, 1, 1, 1, 1, 1, 1]
	]
}
