{
	"level_info": {
		"level_id": 4,
		"level_name": "Grassland 1-4",
		"time_limit_seconds": 240,
		"bgm_track": "theme_02.ogg"
	},
	"grid_config": {
		"cell_width": 32,
		"cell_height": 32,
		"columns": 15,
		"rows": 15
	},
	"spawns": [
		{"type": "player_start", "x": 1, "y": 1},
		{"type": "player_start", "x": 13, "y": 13},
		{"type": "player_start", "x": 1, "y": 13},
		{"type": "player_start", "x": 13, "y": 1},
		{"type": "ghost", "x": 7, "y": 7},
		{"type": "slime", "x": 6, "y": 3},
		{"type": "slime", "x": 8, "y": 11}
	],
	"item_drop_rates": {
		"bomb_up": 0.3,
		"fire_range_up": 0.4,
		"speed_up": 0.2,
		"empty": 0.1
	},
	"map_layout": [
		[1, 1, 1, 1, 1, 1, 1, 1, 1, 1, 1, 1, 1, 1, 1],
		[1, 0, 0, 2, 2, 0, 2, 2, 2, 0, 2, 2, 0, 0, 1],
		[1, 0, 1, 2, 1, 2, 1, 2, 1, 2, 1, 2, 1, 0, 1],
		[1, 2, 2, 2, 2, 2, 0, 2, 0, 2, 2, 2, 2, 2, 1],
		[1, 2, 1, 2, 1, 2, 1, 2, 1, 2, 1, 2, 1, 2, 1],
		[1, 0, 2, 2, 2, 0, 2, 2, 2, 0, 2, 2, 2, 0, 1],
		[1, 2, 1, 2, 1, 2, 1, 2, 1, 2, 1, 2, 1, 2, 1],
		[1, 2, 2, 2, 0, 2, 2, 0, 2, 2, 0, 2, 2, 2, 1],
		[1, 2, 1, 2, 1, 2, 1, 2, 1, 2, 1, 2, 1, 2, 1],
		[1, 0, 2, 2, 2, 0, 2, 2, 2, 0, 2, 2, 2, 0, 1],
		[1, 2, 1, 2, 1, 2, 1, 2, 1, 2, 1, 2, 1, 2, 1],
		[1, 2, 2, 2, 2, 2, 0, 2, 0, 2, 2, 2, 2, 2, 1],
		[1, 0, 1, 2, 1, 2, 1, 2, 1, 2, 1, 2, 1, 0, 1],
		[1, 0, 0, 2, 2, 0, 2, 2, 2, 0, 2, 2, 0, 0, 1],
		[1, 1, 1, 1, 1, 1, 1, 1, 1, 1, 1, 1, 1, 1, 1]
	]
}
