{
	"_comment_meta": "===== 关卡基础信息 =====",
	"level_info": {
		"level_id": 3,
		"level_name": "Grassland 1-3",
		"time_limit_seconds": 240,
		"bgm_track": "theme_01.ogg"
	},

	"grid_config": {
		"cell_width": 32,
		"cell_height": 32,
		"columns": 15,
		"rows": 13
	},

	"_comment_spawns": "===== 动态实体生成 (4xxx玩家, 3xxx敌人) =====",
	"spawns": [
		{"entity_id": 4001, "x": 1, "y": 1,   "_desc": "Player 1"},
		{"entity_id": 4001, "x": 13, "y": 11, "_desc": "Player 2"},
		{"entity_id": 4001, "x": 1, "y": 11,  "_desc": "Player 3"},
		{"entity_id": 4001, "x": 13, "y": 1,  "_desc": "Player 4"},
		{"entity_id": 7002, "x": 1, "y": 11,  "_desc": "Ghost (假设分配了3002)"},
		{"entity_id": 7001, "x": 1, "y": 1,   "_desc": "Slime (假设分配了3001)"},
		{"entity_id": 7001, "x": 8, "y": 6,   "_desc": "Slime"}
	],

	"_comment_drops": "===== 道具掉落权重表 (2xxx道具, 0为空) =====",
	"item_drop_rates": {
		"_comment": "由 ItemManager 读取。2001:炸弹+1, 2002:火力+1, 2003:移速+1",
		"2001": 30,
		"2002": 15,
		"2003": 15,
		"0": 40
	},

	"_comment_layout": "===== 地图矩阵 (0:地板, 1001:不可摧毁石墙, 1002:可摧毁砖块) =====",
	"map_layout": [
		[1001, 1001, 1001, 1001, 1001, 1001, 1001, 1001, 1001, 1001, 1001, 1001, 1001, 1001, 1001],
		[1001,    0,    0, 1002, 1002, 1002, 1001, 1002, 1001, 1002, 1002, 1002,    0,    0, 1001],
		[1001,    0, 1001, 1002, 1001,    0,    0,    0,    0,    0, 1001, 1002, 1001,    0, 1001],
		[1001, 1002, 1002, 1002, 1001,    0, 1001, 1001, 1001,    0, 1001, 1002, 1002, 1002, 1001],
		[1001, 1002, 1001, 1001, 1001,    0, 1001, 1002, 1001,    0, 1001, 1001, 1001, 1002, 1001],
		[1001, 1002,    0,    0,    0,    0, 1002, 1002, 1002,    0,    0,    0,    0, 1002, 1001],
		[1001, 1001, 1001, 1001, 1001, 1002, 1002, 1002, 1002, 1002, 1001, 1001, 1001, 1001, 1001],
		[1001, 1002,    0,    0,    0,    0, 1002, 1002, 1002,    0,    0,    0,    0, 1002, 1001],
		[1001, 1002, 1001, 1001, 1001,    0, 1001, 1002, 1001,    0, 1001, 1001, 1001, 1002, 1001],
		[1001, 1002, 1002, 1002, 1001,    0, 1001, 1001, 1001,    0, 1001, 1002, 1002, 1002, 1001],
		[1001,    0, 1001, 1002, 1001,    0,    0,    0,    0,    0, 1001, 1002, 1001,    0, 1001],
		[1001,    0,    0, 1002, 1002, 1002, 1001, 1002, 1001, 1002, 1002, 1002,    0,    0, 1001],
		[1001, 1001, 1001, 1001, 1001, 1001, 1001, 1001, 1001, 1001, 1001, 1001, 1001, 1001, 1001]
	]
}
